NO ./ressource/wolftex/greystone.xpm
SO ./ressource/wolftex/greystone.xpm
WE ./ressource/iyan.xpm
EA ./ressource/wolftex/greystone.xpm

F ./ressource/wolftex/greystone.xpm
C ./ressource/wolftex/greystone.xpm
D ./ressource/wolftex/wood.xpm

1111111111111111111111111111111111111111111111111111111111111111111111111111111111
1E20202020202020202020202020202020202020202020202020202020202020202020202020202021
1111111111111111111111111111111111111111111111111111111111111111111111111111111111