NO ./ressource/scary/s_wall.xpm
SO ./ressource/scary/s_wall.xpm
WE ./ressource/scary/s_wall.xpm
EA ./ressource/scary/s_wall.xpm

F ./ressource/scary/s_floor.xpm
C ./ressource/scary/s_celling.xpm
D ./ressource/scary/s_door.xpm

        1111111111111111111111111
        1000000000110000000000001
        1011000001110000000100001
        1001000000200000000000001
111111111011000001110000000000001
100000000011000001112111111111111
11110111111111011100000010001
11112111111111011101010010001
11000000110101011100000020001
10000000000000001100000010001
10000000000000001101010010001
11000001110101011111011110N0111
11110111 1110101 101111010001
11111111 1111111 111111111111