NO ./ressource/iyan.xpm
SO ./ressource/iyan.xpm
WE ./ressource/iyan.xpm
EA ./ressource/iyan.xpm

F ./ressource/iyan.xpm
C ./ressource/iyan.xpm
D ./ressource/iyan.xpm

1111111
1000001
111110111
	100N1
	11111