NO		./ressource/iyan.xpm
WE ./ressource/iyan.xpm
EA 				./ressource/iyan.xpm
    
SO ./ressource/iyan.xpm

F                255,255,255		
C 255,255,255



11111              11111111111111
10001              100000000N0011
10001              11111111111111
10001
11111