NO ./ressource/iyan.xpm
SO ./ressource/iyan.xpm
WE ./ressource/iyan.xpm
EA ./ressource/iyan.xpm

F ./ressource/iyan.xpm
C ./ressource/iyan.xpm
D ./ressource/iyan.xpm

11111
10001
10201
100N1
11111